5,9,9,9,9,9,9,9,9,4,
3,1,1,1,1,1,1,1,1,2,
3,1,1,1,1,1,1,1,1,2,
3,1,1,1,1,1,1,1,1,2,
3,1,1,1,1,1,1,1,1,2,
3,1,1,1,1,1,1,1,1,2,
3,1,1,1,1,1,1,1,1,2,
3,1,1,1,1,1,1,1,1,2,
3,1,1,1,1,1,1,1,1,2,
6,8,8,8,8,8,10,8,8,7