0,0,0,0,0,0,0,0,0,0,0,0,
0,0,5,9,9,9,9,9,9,9,9,4,
0,0,3,1,1,1,1,1,1,1,1,2,
0,0,3,1,1,1,1,1,1,1,1,2,
0,0,3,1,1,1,1,1,1,1,1,2,
0,0,3,1,1,1,1,1,1,1,1,2,
0,0,3,1,1,1,1,1,1,1,1,2,
0,0,3,1,1,1,1,1,1,1,1,2,
0,0,3,1,1,1,1,1,1,1,1,2,
0,0,3,1,1,1,1,1,1,1,1,2,
0,0,6,8,8,8,8,8,10,8,8,7