2,2,2,2,2,2,2,2,2,2,2,2,2,2,2,2,2,2,2,2,2,2,2,2,2,2,2,2,2,2,2,2,2,2,2,2,2,2,2,2,
2,1,1,1,1,1,1,1,1,1,1,1,1,1,1,1,1,1,1,1,1,1,1,1,1,4,6,3,3,3,3,3,3,3,3,3,3,3,3,2,
2,1,1,1,1,1,1,1,1,1,1,1,1,1,1,1,1,1,1,1,1,1,1,1,1,4,6,3,3,3,3,3,3,3,3,3,3,3,3,2,
2,1,1,1,1,1,1,1,1,1,1,1,1,1,1,1,1,1,1,1,1,1,1,1,1,4,6,3,3,3,3,3,3,3,3,3,3,3,3,2,
2,1,1,1,2,1,1,2,1,1,2,1,1,2,1,1,2,1,1,2,1,1,1,1,1,4,6,3,3,3,3,3,3,3,3,3,3,3,3,2,
2,1,1,1,2,1,1,2,1,1,2,1,1,2,1,1,2,1,1,2,1,1,1,1,1,4,6,3,3,3,3,3,3,3,3,3,3,3,3,2,
2,1,1,1,2,1,1,2,1,1,2,1,1,2,1,1,2,1,1,2,1,1,1,1,1,4,6,1,1,1,1,1,1,1,1,1,1,1,3,2,
2,1,1,1,2,1,1,2,1,1,2,1,1,2,1,1,2,1,1,2,1,1,1,1,1,4,6,1,1,1,1,1,1,1,1,1,1,1,3,2,
2,1,1,1,2,1,1,2,1,1,2,1,1,2,1,1,2,1,1,2,1,1,1,1,1,4,6,1,1,1,1,1,1,1,1,1,1,1,3,2,
2,1,1,1,2,1,1,2,1,1,2,1,1,2,1,1,2,1,1,2,1,1,1,1,1,4,6,1,1,1,1,1,1,1,1,1,1,1,3,2,
2,1,1,1,2,1,1,2,1,1,2,1,1,2,1,1,2,1,1,2,1,1,1,1,1,4,6,1,1,1,1,1,1,1,1,1,1,1,3,2,
2,1,1,1,2,1,1,2,1,1,2,1,1,2,1,1,2,1,1,2,1,1,1,1,1,4,6,1,1,1,1,1,1,1,1,1,1,1,3,2,
2,1,1,1,2,1,1,2,1,1,2,1,1,2,1,1,2,1,1,2,1,1,1,1,1,4,6,1,1,1,1,1,1,1,1,1,1,1,3,2,
2,1,1,1,2,1,1,2,1,1,2,1,1,2,1,1,2,1,1,2,1,1,1,1,1,4,6,1,1,1,1,1,1,1,1,1,1,1,3,2,
2,1,1,1,2,1,1,2,1,1,2,1,1,2,1,1,2,1,1,2,1,1,1,1,1,4,6,1,1,1,1,1,1,1,1,1,1,1,3,2,
2,1,1,1,1,1,1,1,1,1,1,1,1,1,1,1,1,1,1,1,1,1,1,1,1,4,6,1,1,1,1,1,1,1,1,1,1,1,3,2,
2,1,1,1,1,1,1,1,1,1,1,1,1,1,1,1,1,1,1,1,1,1,1,1,1,4,6,1,1,1,1,1,1,1,1,1,1,1,3,2,
2,1,1,7,7,7,7,1,1,1,1,7,7,7,7,7,1,1,1,1,1,1,1,1,1,4,6,1,1,1,1,1,1,1,1,1,1,1,3,2,
2,1,1,7,7,7,7,1,1,1,1,7,7,7,7,7,1,1,1,1,1,1,1,1,1,4,6,1,1,1,1,1,1,1,1,1,1,1,3,2,
2,1,1,8,8,12,8,1,1,1,1,9,9,12,9,9,1,1,1,1,1,1,1,1,1,4,6,1,1,1,1,1,1,1,1,1,1,1,3,2,
2,1,1,1,1,1,1,1,1,1,1,1,1,1,1,1,1,1,1,1,1,1,1,1,1,4,6,1,1,1,1,1,1,1,1,1,1,1,3,2,
2,1,1,1,1,1,1,1,1,1,1,1,1,1,1,1,1,1,1,1,1,1,1,1,1,4,6,1,1,1,1,1,1,1,1,1,1,1,3,2,
2,1,1,1,1,1,1,1,1,1,1,1,1,1,1,1,1,1,1,1,1,1,1,1,1,4,6,1,1,1,1,1,1,1,1,1,1,1,3,2,
2,1,1,1,1,1,1,1,1,1,1,1,1,1,1,1,1,1,1,1,1,1,1,1,1,4,6,1,1,1,1,1,1,1,1,1,1,1,3,2,
2,1,1,1,1,1,1,1,1,1,1,1,1,1,1,1,1,1,1,1,1,1,1,1,1,4,6,5,5,5,5,5,5,5,5,5,5,5,3,2,
2,1,1,1,1,1,1,1,1,1,1,1,1,1,1,1,1,1,1,1,1,1,1,1,1,4,6,5,5,5,5,10,5,5,5,5,5,5,3,2,
2,1,1,1,1,1,1,1,1,1,1,1,1,1,1,1,1,1,1,1,1,1,1,1,1,1,1,1,1,1,1,1,1,1,1,1,1,1,3,2,
2,1,1,1,1,1,1,1,1,1,1,1,1,1,1,1,1,1,1,1,1,1,1,1,1,1,1,1,1,1,1,1,1,1,1,1,1,1,3,2,
2,1,1,7,7,7,7,7,7,1,1,1,1,7,7,7,7,7,1,1,1,1,1,1,1,1,1,1,1,1,1,1,1,1,1,1,1,1,3,2,
2,1,1,7,7,7,7,7,7,1,1,1,1,7,7,7,7,7,1,1,1,1,1,1,1,1,1,1,1,1,1,1,1,1,1,1,1,1,3,2,
2,1,1,8,8,8,8,11,8,1,1,1,1,9,9,11,9,9,1,1,1,1,1,1,1,1,1,1,1,1,1,1,1,1,1,1,1,1,3,2,
2,1,1,1,1,1,1,1,1,1,1,1,1,1,1,1,1,1,1,1,1,1,1,1,1,1,3,3,3,3,3,3,1,1,1,1,1,1,3,2,
2,1,1,1,1,1,1,1,1,1,1,1,1,1,1,1,1,1,1,1,1,1,1,1,1,3,3,3,3,3,3,3,1,1,1,1,1,1,3,2,
2,1,1,1,1,1,1,1,1,1,1,1,1,1,1,1,1,1,1,1,1,1,1,1,1,3,3,3,3,3,3,3,3,1,1,1,1,1,3,2,
2,1,1,1,1,1,1,1,1,1,1,1,1,1,1,1,1,1,1,1,1,1,1,1,1,3,3,3,3,3,3,3,3,3,1,1,1,1,3,2,
2,1,1,1,1,1,1,1,1,1,1,1,1,1,1,1,1,1,1,1,1,1,1,1,1,3,3,3,3,3,3,3,1,3,1,1,1,1,3,2,
2,1,1,1,1,1,1,1,1,1,1,1,1,1,1,1,1,1,1,1,1,1,1,1,1,3,3,3,3,3,3,3,1,3,3,3,3,1,3,2,
2,1,1,1,1,1,1,1,1,1,1,1,1,1,1,1,1,1,1,1,1,1,1,1,1,1,3,3,3,3,3,1,1,1,1,1,3,3,3,2,
2,1,1,1,1,1,1,1,1,1,1,1,1,1,1,1,1,1,1,1,1,1,1,1,1,1,1,1,1,1,1,1,1,1,1,1,1,1,1,2,
2,2,2,2,2,2,2,2,2,2,2,2,2,2,2,2,2,2,2,2,2,2,2,2,2,2,2,2,2,2,2,2,2,2,2,2,2,2,2,2